111
101
1N1
111



      1111111111111111111111111111111111111111
      1000000000000000000000000000000000000001
      1000000000000000000000000000000000000001
      1000000000000000000000000000000000000001
1111111000000000000000000000000000000001111111
1000000000000000000000000000000000000001
1000000000000000000110000000000000000001
1000000000000000000000000000000000000001
1000000000000000000000000000000000000001
1000000000000000000000000000000000000001
1000000000000000000000000000000000000001
1000000000000000000000000000000000000001
1000000000000000000000000000000000000001
1000000000000000000000000000000000000001
1000000000000000000000000000000000000001
1000000000000000000000000000000000000001
1000000000000000000000000000000000000001
1000000000000000000000000000000000000001
1000000000000000000000000000000000000001
1000000000000000000000000000000000000001
1000000000000000000S00000000000000000001
1000000000000000000000000000000000000001
1000000000001111000000011110000000000001
1111111111111  111111111  11111111111111