NO ./textures/north_wall.xpm
SO ./textures/suki_licking.xpm
EA ./textures/suki_paw_hanging.xpm
WE ./textures/suki_yawning.xpm

F 40,35,30

C 85,119,136

11111111111111111111111
10000000000000000000001
1000000000000000000N001
11111111111111111111111