NO ./textures/north_wall.xpm
SO ./textures/south_wall.xpm
EA ./textures/east_wall.xpm
WE ./textures/west_wall.xpm
F 40,35,30
C 85,119,136

	1111111111111111111111111
1000000000110000000000001
1011000001110000000000001
100100000000000000000000111111111
111111111011000001110000000000001
100000000011000001110111111011111
11110111111111011100000010001
11110111111111011101010010001
11000000110101011100000010001
100000000R0000001100000010001
10000000000000001101010010001
11000001110101011111011110N0111
11110111111101011101111010001
11111111111111111111111111111