F 40,40,40
C 50,50,50

11111111111111
10000000000001
100000000000N1
11111111111111