NO ./textures/suki_licking.xpm
SO ./textures/suki_shrimp.xpm
EA ./textures/suki_paw_hanging.xpm
WE ./textures/suki_yawning.xpm
C 40,35,30
F 85,119,136
111111111111111111111111111111
1N1
111