NO ./textures/north_wall.xpm
SO ./textures/south_wall.xpm
EA ./textures/east_wall.xpm
WE ./textures/west_wall.xpm
F 40,35,30
C 85,119,136  



      1111111111111111111111111111111111111111
      1000000000000000000000000000000000000001
      1000000000000000000000000000000000000001
      1000000000000000000000000000000000000001
1111111000000000000000000000000000000001111111
1000000000000000000000000000000000000001
1000000000000000000110000000000000000001
1000000000000000000000000000000000000001
1000000000000000000000000000000000000001
1000000000000000000000000000000000000001
1000000000000000000000000000000000000001
1000000000000000000000000000000000000001
1000000000000000000000000000000000000001
1000000000000000000000000000000000000001
1000000000000000000000000000000000000001
1000000000000000000000000000000000000001
1000000000000000000000000000000000000001
1000000000000000000000000000000000000001
1000000000000000000000000000000000000001
1000000000000000000000000000000000000001
1000000000000000000000000000000000000001
1000000000000000000000000000000000000001
1000000000001111000000011110000000000001
1111111111111  111111111  11111111111111
