NO./textures/suki_licking.xpm
SO ./textures/suki_shrimp.xpm
EA ./textures/suki_paw_hanging.xpm
WE ./textures/suki_yawning.xpm

C ,40,35,30
F	85,119,136

1111111111111111111111111
10000000001100000000000011111
11111011000001110000000000001
100100000000000000000000111111111
111111111011000001110000000000001
100000000011000001110111111011111
11110111111111011100000010001
11110111111111011101010010001
11000000110101011100000010001
10000000000000001100000010001
1000000000000N001101010010001
10000011101010111110111100001
10000111111101011101111010001
11111111111111111111111111111