NO./textures/suki_licking.xpm



SO 		./textures/suki_shrimp.xpm
EA ./textures/suki_paw_hanging.xpm
WE ./textures/suki_yawning.xpm

C 40,35,30
F	85,119,136

1111111111111
 111111111111111
 10000000000001
 100000010000S1
 10000000000011
111111111110111
          111
         1
			1
11111111111111